"a" = (/turf/simulated/ocean,/area/space)
"b" = (/turf/simulated/open,/area/beach)
"c" = (/turf/simulated/wall/constructed/r_wall/hull,/area/beach)
"d" = (/turf/simulated/floor/tiled/dark,/area/beach)
"e" = (/turf/simulated/floor/tiled/dark,/area/wizard_station)
"f" = (/obj/structure/ladder/updown,/turf/simulated/ocean,/area/space)
"g" = (/turf/simulated/floor/tiled/dark,/area/chapel)
"h" = (/turf/simulated/floor/tiled/dark,/area/neptune)
"i" = (/obj/structure/ladder/updown,/turf/simulated/floor/tiled/dark,/area/beach)

(1,1,1) = {"
aaaaaaaaaaaaaaaaaaaaaaaaaaaaaaaaaaaaaaaaaaaaaaaaaaaaaaaaaaaaaaaaaaaaaaaaaaaaaaaaaaaaaaaaaaaaaaaaaaaaaaaaaa
aaaaaaaaaaaaaaaaaaaaaaaaaaaaaaaaaaaaaaaaaaaaaaaaaaaaaaaaaaaaaaaaaaaaaaaaaaaaaaaaaaaaaaaaaaaaaaaaaaaaaaaaaa
aaaaaaaaaaaaaaaaaaaaaaaaaaaaaaaaaaaaaaaaaaaaaaaaaaaaaaaaaaaaaaaaaaaaaaaaaaaaaaaaaaaaaaaaaaaaaaaaaaaaaaaaaa
aaaaaaaaaaaaaaaaaaaaaaaaaaaaaaaaaaaaaaaaaaaaaaaaaaaaaaaaaaaaaaaaaaaaaaaaaaaaaaaaaaaaaaaaaaaaaaaaaaaaaaaaaa
aaaaaaaaaaaaaaaaaaaaaaaaaaaaaaaaaaaaaaaaaaaaaaaaaaaaaaaaaaaaaaaaaaaaaaaaaaaaaaaaaaaaaaaaaaaaaaaaaaaaaaaaaa
aaaaaaaaaaaaaaaaaaaaaaaaaaaaaaaaaaaaaaaaaaaaaaaaaaaaaaaaaaaaaaaaaaaaaaaaaaaaaaaaaaaaaaaaaaaaaaaaaaaaaaaaaa
aaaaaaaaaaaaaaaaaaaaaaaaaaaaaaaaaaaaaaaaaaaaaaaaaaaaaaaaaaaaaaaaaaaaaaaaaaaaaaaaaaaaaaaaaaaaaaaaaaaaaaaaaa
aaaaaaaaaaaaaaaaaaaaaaaaaaaaaaaaaaaaaaaaaaaaaaaaaaaaaaaaaaaaaaaaaaaaaaaaaaaaaaaaaaaaaaaaaaaaaaaaaaaaaaaaaa
aaaaaaaaaaaaaaaaaaaaaaaaaaaaaaaaaaaaaaafaaaaaaaaaaaaaaaaaaaaaaaaaaaaaaaaaaaaaaaaaaaaaaaaaaaaaaaaaaaaaaaaaa
aaaaaaaaaaaaaaaaaaaaaaaaaaaaaaaaaaaaaaaaaaaaaaaaaaaaaaaaaaaaaaaaaaaaaaaaaaaaaaaaaaaaaaaaaaaaaaaaaaaaaaaaaa
bbbbbbbbbbbbbbbbbbbbbbbbbbbbbbbbbbbbbbbbbbbbbbbbbbbbbbbbbbbbbbbbbbbbbbbbbbbbbbbbbbbbbbbbbbbbbbbbbbbbbbbbbb
bbbbbbbbbbbbbbbbbbbbbbbbbbccccccccccccccccccccccccccccccccccccccccccccccccccccccccbbbbbbbbbbbbbbbbbbbbbbbb
bbbbbbbbbbbbbbbbbbbbbbccccddddddddddddddddddddddddddddddddddddddddddddddddddddddddccccbbbbbbbbbbbbbbbbbbbb
bbbbbbbbbbbbbbbbbbbcccddddddddddddddddddddddddddddddddddddddddddddddddddddddddddddddddcccbbbbbbbbbbbbbbbbb
bbbbbbbbbbbbbbbbcccddddddddddddddddddddddddddddddddddddddddddddddddddddddddddddddddddddddcccbbbbbbbbbbbbbb
bbbbbbbbbbbbbcccddddddddddddddddddddddddddddddddddddddddddddddddddddddddddddddddddddddddddddcccbbbbbbbbbbb
bbbbbbbbbbcccdddddddddddddddddddddddddddddddddddeeeeeeeeeeeeeeeddddddddddddddddddddddddddddddddcccbbbbbbbb
bbbbbbbbccddddddddddddddddddddddddddddddddddddddeeeeeeeeeeeeeeedddddddddddddddddddddddddddddddddddccbbbbbb
bbbbbbccddddddddddddddddddddddddddddddddddddddddeeeeeeeeeeeeeeedddddddddddddddddddddddddddddddddddddccbbbb
bbbbccddddddddddddddddddddddddddddddddddddddddddeeeeeeeeeeeeeeedddddddddddddddddddddddddddddddddddddddccbb
bbccddddddddddddddddddddddddddddddddddddddddddddeeeeeeeeeeeeeeegghhhddddddddddddddddddddddddddddddddddddcc
bbccdddddddddddddddddddddddddddddddddiddddddddddeeeeeeeeeeeeeeegghhhddddddddddddddddddddddddddddddddddddcc
bbbbccddddddddddddddddddddddddddddddddddddddddddeeeeeeeeeeeeeeedddddddddddddddddddddddddddddddddddddddccbb
bbbbbbccddddddddddddddddddddddddddddddddddddddddeeeeeeeeeeeeeeedddddddddddddddddddddddddddddddddddddccbbbb
bbbbbbbbccddddddddddddddddddddddddddddddddddddddeeeeeeeeeeeeeeedddddddddddddddddddddddddddddddddddccbbbbbb
bbbbbbbbbbcccddddddddddddddddddddddddddddbdddddddddddddddddddddddddddddddddddddddddddddddddddddcccbbbbbbbb
bbbbbbbbbbbbbcccddddddddddddddddddddddddddddddddddddddddddddddddddddddddddddddddddddddddddddcccbbbbbbbbbbb
bbbbbbbbbbbbbbbbcccddddddddddddddddddddddddddddddddddddddddddddddddddddddddddddddddddddddcccbbbbbbbbbbbbbb
bbbbbbbbbbbbbbbbbbbcccddddddddddddddddddddddddddddddddddddddddddddddddddddddddddddddddcccbbbbbbbbbbbbbbbbb
bbbbbbbbbbbbbbbbbbbbbbccccddddddddddddddddddddddddddddddddddddddddddddddddddddddddccccbbbbbbbbbbbbbbbbbbbb
bbbbbbbbbbbbbbbbbbbbbbbbbbccccccccccccccccccccccccccccccccccccccccccccccccccccccccbbbbbbbbbbbbbbbbbbbbbbbb
bbbbbbbbbbbbbbbbbbbbbbbbbbbbbbbbbbbbbbbbbbbbbbbbbbbbbbbbbbbbbbbbbbbbbbbbbbbbbbbbbbbbbbbbbbbbbbbbbbbbbbbbbb
aaaaaaaaaaaaaaaaaaaaaaaaaaaaaaaaaaaaaaaaaaaaaaaaaaaaaaaaaaaaaaaaaaaaaaaaaaaaaaaaaaaaaaaaaaaaaaaaaaaaaaaaaa
aaaaaaaaaaaaaaaaaaaaaaaaaaaaaaaaaaaaaaaaaaaaaaaaaaaaaaaaaaaaaaaaaaaaaaaaaaaaaaaaaaaaaaaaaaaaaaaaaaaaaaaaaa
aaaaaaaaaaaaaaaaaaaaaaaaaaaaaaaaaaaaaaaaaaaaaaaaaaaaaaaaaaaaaaaaaaaaaaaaaaaaaaaaaaaaaaaaaaaaaaaaaaaaaaaaaa
aaaaaaaaaaaaaaaaaaaaaaaaaaaaaaaaaaaaaaaaaaaaaaaaaaaaaaaaaaaaaaaaaaaaaaaaaaaaaaaaaaaaaaaaaaaaaaaaaaaaaaaaaa
aaaaaaaaaaaaaaaaaaaaaaaaaaaaaaaaaaaaaaaaaaaaaaaaaaaaaaaaaaaaaaaaaaaaaaaaaaaaaaaaaaaaaaaaaaaaaaaaaaaaaaaaaa
aaaaaaaaaaaaaaaaaaaaaaaaaaaaaaaaaaaaaaaaaaaaaaaaaaaaaaaaaaaaaaaaaaaaaaaaaaaaaaaaaaaaaaaaaaaaaaaaaaaaaaaaaa
aaaaaaaaaaaaaaaaaaaaaaaaaaaaaaaaaaaaaaaaaaaaaaaaaaaaaaaaaaaaaaaaaaaaaaaaaaaaaaaaaaaaaaaaaaaaaaaaaaaaaaaaaa
aaaaaaaaaaaaaaaaaaaaaaaaaaaaaaaaaaaaaaaaaaaaaaaaaaaaaaaaaaaaaaaaaaaaaaaaaaaaaaaaaaaaaaaaaaaaaaaaaaaaaaaaaa
"}
