"a" = (/turf/simulated/ocean,/area/space)
"b" = (/turf/simulated/open,/area/beach)
"c" = (/turf/simulated/wall/constructed/r_wall/hull,/area/beach)
"d" = (/turf/simulated/floor/tiled/dark,/area/beach)
"e" = (/turf/simulated/floor/tiled/dark,/area/wizard_station)
"f" = (/turf/simulated/floor/tiled/dark,/area/chapel)
"g" = (/turf/simulated/floor/tiled/dark,/area/neptune)
"h" = (/obj/structure/ladder/updown,/turf/simulated/floor/tiled/dark,/area/beach)

(1,1,1) = {"
aaaaaaaaaaaaaaaabaaaaaaaaaaaaaaaaaaaaaaaaaaaaaaaaaaaaaaaaaaaaaaaaaaaaaaaaaaaaaaaaaaaaaaaaaaaaaaaaaaaaaaaaa
aaaaaaaaaaaaaaaabaaaaaaaaaaaaaaaaaaaaaaaaaaaaaaaaaaaaaaaaaaaaaaaaaaaaaaaaaaaaaaaaaaaaaaaaaaaaaaaaaaaaaaaaa
aaaaaaaaaaaaaaaabaaaaaaaaaaaaaaaaaaaaaaaaaaaaaaaaaaaaaaaaaaaaaaaaaaaaaaaaaaaaaaaaaaaaaaaaaaaaaaaaaaaaaaaaa
aaaaaaaaaaaaaaaabaaaaaaaaaaaaaaaaaaaaaaaaaaaaaaaaaaaaaaaaaaaaaaaaaaaaaaaaaaaaaaaaaaaaaaaaaaaaaaaaaaaaaaaaa
aaaaaaaaaaaaaaaabaaaaaaaaaaaaaaaaaaaaaaaaaaaaaaaaaaaaaaaaaaaaaaaaaaaaaaaaaaaaaaaaaaaaaaaaaaaaaaaaaaaaaaaaa
aaaaaaaaaaaaaaaabaaaaaaaaaaaaaaaaaaaaaaaaaaaaaaaaaaaaaaaaaaaaaaaaaaaaaaaaaaaaaaaaaaaaaaaaaaaaaaaaaaaaaaaaa
aaaaaaaaaaaaaaaabaaaaaaaaaaaaaaaaaaaaaaaaaaaaaaaaaaaaaaaaaaaaaaaaaaaaaaaaaaaaaaaaaaaaaaaaaaaaaaaaaaaaaaaaa
aaaaaaaaaaaaaaaabaaaaaaaaaaaaaaaaaaaaaaaaaaaaaaaaaaaaaaaaaaaaaaaaaaaaaaaaaaaaaaaaaaaaaaaaaaaaaaaaaaaaaaaaa
aaaaaaaaaaaaaaaabaaaaaaaaaaaaaaaaaaaaaaaaaaaaaaaaaaaaaaaaaaaaaaaaaaaaaaaaaaaaaaaaaaaaaaaaaaaaaaaaaaaaaaaaa
aaaaaaaaaaaaaaaaaaaaaaaaaaaaaaaaaaaaaaaaaaaaaaaaaaaaaaaaaaaaaaaaaaaaaaaaaaaaaaaaaaaaaaaaaaaaaaaaaaaaaaaaaa
bbbbbbbbbbbbbbbbbbbbbbbbbbbbbbbbbbbbbbbbbbbbbbbbbbbbbbbbbbbbbbbbbbbbbbbbbbbbbbbbbbbbbbbbbbbbbbbbbbbbbbbbbb
bbbbbbbbbbbbbbbbbbbbbbbbbbccccccccccccccccccccccccccccccccccccccccccccccccccccccccbbbbbbbbbbbbbbbbbbbbbbbb
bbbbbbbbbbbbbbbbbbbbbbccccddddddddddddddddddddddddddddddddddddddddddddddddddddddddccccbbbbbbbbbbbbbbbbbbbb
bbbbbbbbbbbbbbbbbbbcccddddddddddddddddddddddddddddddddddddddddddddddddddddddddddddddddcccbbbbbbbbbbbbbbbbb
bbbbbbbbbbbbbbbbcccddddddddddddddddddddddddddddddddddddddddddddddddddddddddddddddddddddddcccbbbbbbbbbbbbbb
bbbbbbbbbbbbbcccddddddddddddddddddddddddddddddddddddddddddddddddddddddddddddddddddddddddddddcccbbbbbbbbbbb
bbbbbbbbbbcccdddddddddddddddddddddddddddddddddddeeeeeeeeeeeeeeeddddddddddddddddddddddddddddddddcccbbbbbbbb
bbbbbbbbccddddddddddddddddddddddddddddddddddddddeeeeeeeeeeeeeeedddddddddddddddddddddddddddddddddddccbbbbbb
bbbbbbccddddddddddddddddddddddddddddddddddddddddeeeeeeeeeeeeeeedddddddddddddddddddddddddddddddddddddccbbbb
bbbbccddddddddddddddddddddddddddddddddddddddddddeeeeeeeeeeeeeeedddddddddddddddddddddddddddddddddddddddccbb
bbccddddddddddddddddddddddddddddddddddddddddddddeeeeeeeeeeeeeeeffgggddddddddddddddddddddddddddddddddddddcc
bbccdddddddddddddddddddddddddddddddddhddddddddddeeeeeeeeeeeeeeeffgggddddddddddddddddddddddddddddddddddddcc
bbbbccddddddddddddddddddddddddddddddddddddddddddeeeeeeeeeeeeeeedddddddddddddddddddddddddddddddddddddddccbb
bbbbbbccddddddddddddddddddddddddddddddddddddddddeeeeeeeeeeeeeeedddddddddddddddddddddddddddddddddddddccbbbb
bbbbbbbbccddddddddddddddddddddddddddddddddddddddeeeeeeeeeeeeeeedddddddddddddddddddddddddddddddddddccbbbbbb
bbbbbbbbbbcccddddddddddddddddddddddddddddddddddddddddddddddddddddddddddddddddddddddddddddddddddcccbbbbbbbb
bbbbbbbbbbbbbcccddddddddddddddddddddddddddddddddddddddddddddddddddddddddddddddddddddddddddddcccbbbbbbbbbbb
bbbbbbbbbbbbbbbbcccddddddddddddddddddddddddddddddddddddddddddddddddddddddddddddddddddddddcccbbbbbbbbbbbbbb
bbbbbbbbbbbbbbbbbbbcccddddddddddddddddddddddddddddddddddddddddddddddddddddddddddddddddcccbbbbbbbbbbbbbbbbb
bbbbbbbbbbbbbbbbbbbbbbccccddddddddddddddddddddddddddddddddddddddddddddddddddddddddccccbbbbbbbbbbbbbbbbbbbb
bbbbbbbbbbbbbbbbbbbbbbbbbbccccccccccccccccccccccccccccccccccccccccccccccccccccccccbbbbbbbbbbbbbbbbbbbbbbbb
bbbbbbbbbbbbbbbbbbbbbbbbbbbbbbbbbbbbbbbbbbbbbbbbbbbbbbbbbbbbbbbbbbbbbbbbbbbbbbbbbbbbbbbbbbbbbbbbbbbbbbbbbb
aaaaaaaaaaaaaaaaaaaaaaaaaaaaaaaaaaaaaaaaaaaaaaaaaaaaaaaaaaaaaaaaaaaaaaaaaaaaaaaaaaaaaaaaaaaaaaaaaaaaaaaaaa
aaaaaaaaaaaaaaaaaaaaaaaaaaaaaaaaaaaaaaaaaaaaaaaaaaaaaaaaaaaaaaaaaaaaaaaaaaaaaaaaaaaaaaaaaaaaaaaaaaaaaaaaaa
aaaaaaaaaaaaaaaaaaaaaaaaaaaaaaaaaaaaaaaaaaaaaaaaaaaaaaaaaaaaaaaaaaaaaaaaaaaaaaaaaaaaaaaaaaaaaaaaaaaaaaaaaa
aaaaaaaaaaaaaaaaaaaaaaaaaaaaaaaaaaaaaaaaaaaaaaaaaaaaaaaaaaaaaaaaaaaaaaaaaaaaaaaaaaaaaaaaaaaaaaaaaaaaaaaaaa
aaaaaaaaaaaaaaaaaaaaaaaaaaaaaaaaaaaaaaaaaaaaaaaaaaaaaaaaaaaaaaaaaaaaaaaaaaaaaaaaaaaaaaaaaaaaaaaaaaaaaaaaaa
aaaaaaaaaaaaaaaaaaaaaaaaaaaaaaaaaaaaaaaaaaaaaaaaaaaaaaaaaaaaaaaaaaaaaaaaaaaaaaaaaaaaaaaaaaaaaaaaaaaaaaaaaa
aaaaaaaaaaaaaaaaaaaaaaaaaaaaaaaaaaaaaaaaaaaaaaaaaaaaaaaaaaaaaaaaaaaaaaaaaaaaaaaaaaaaaaaaaaaaaaaaaaaaaaaaaa
aaaaaaaaaaaaaaaaaaaaaaaaaaaaaaaaaaaaaaaaaaaaaaaaaaaaaaaaaaaaaaaaaaaaaaaaaaaaaaaaaaaaaaaaaaaaaaaaaaaaaaaaaa
"}
