"a" = (/turf/simulated/ocean,/area/space)
"b" = (/turf/simulated/open,/area/beach)
"c" = (/turf/simulated/wall/constructed/r_wall/hull,/area/beach)
"d" = (/turf/simulated/floor/tiled/dark,/area/beach)
"e" = (/obj/machinery/door/unpowered/simple/wood,/turf/simulated/wall/constructed/r_wall/hull,/area/beach)
"f" = (/obj/machinery/door/unpowered/simple/wood,/turf/simulated/floor/tiled/dark,/area/beach)
"g" = (/obj/structure/ladder,/turf/simulated/floor/tiled/dark,/area/beach)
"h" = (/obj/structure/ladder/updown,/turf/simulated/floor/tiled/dark,/area/beach)

(1,1,1) = {"
aaaaaaaaaaaaaaaaaaaaaaaaaaaaaaaaaaaaaaaaaaaaaaaaaaaaaaaaaaaaaaaaaaaaaaaaaaaaaaaaaaaaaaaaaaaaaaaaaaaaaaaaaa
aaaaaaaaaaaaaaaaaaaaaaaaaaaaaaaaaaaaaaaaaaaaaaaaaaaaaaaaaaaaaaaaaaaaaaaaaaaaaaaaaaaaaaaaaaaaaaaaaaaaaaaaaa
aaaaaaaaaaaaaaaaaaaaaaaaaaaaaaaaaaaaaaaaaaaaaaaaaaaaaaaaaaaaaaaaaaaaaaaaaaaaaaaaaaaaaaaaaaaaaaaaaaaaaaaaaa
aaaaaaaaaaaaaaaaaaaaaaaaaaaaaaaaaaaaaaaaaaaaaaaaaaaaaaaaaaaaaaaaaaaaaaaaaaaaaaaaaaaaaaaaaaaaaaaaaaaaaaaaaa
aaaaaaaaaaaaaaaaaaaaaaaaaaaaaaaaaaaaaaaaaaaaaaaaaaaaaaaaaaaaaaaaaaaaaaaaaaaaaaaaaaaaaaaaaaaaaaaaaaaaaaaaaa
aaaaaaaaaaaaaaaaaaaaaaaaaaaaaaaaaaaaaaaaaaaaaaaaaaaaaaaaaaaaaaaaaaaaaaaaaaaaaaaaaaaaaaaaaaaaaaaaaaaaaaaaaa
aaaaaaaaaaaaaaaaaaaaaaaaaaaaaaaaaaaaaaaaaaaaaaaaaaaaaaaaaaaaaaaaaaaaaaaaaaaaaaaaaaaaaaaaaaaaaaaaaaaaaaaaaa
aaaaaaaaaaaaaaaaaaaaaaaaaaaaaaaaaaaaaaaaaaaaaaaaaaaaaaaaaaaaaaaaaaaaaaaaaaaaaaaaaaaaaaaaaaaaaaaaaaaaaaaaaa
aaaaaaaaaaaaaaaaaaaaaaaaaaaaaaaaaaaaaaaaaaaaaaaaaaaaaaaaaaaaaaaaaaaaaaaaaaaaaaaaaaaaaaaaaaaaaaaaaaaaaaaaaa
aaaaaaaaaaaaaaaaaaaaaaaaaaaaaaaaaaaaaaaaaaaaaaaaaaaaaaaaaaaaaaaaaaaaaaaaaaaaaaaaaaaaaaaaaaaaaaaaaaaaaaaaaa
bbbbbbbbbbbbbbbbbbbbbbbbbbbbbbbbbbbbbbbbbbbbbbbbbbbbbbbbbbbbbbbbbbbbbbbbbbbbbbbbbbbbbbbbbbbbbbbbbbbbbbbbbb
bbbbbbbbbbbbbbbbbbbbbbbbbbccccccccccccccccccccccccccccccccccccccccccccccccccccccccbbbbbbbbbbbbbbbbbbbbbbbb
bbbbbbbbbbbbbbbbbbbbbbccccddddddddddddddddddddddddddddddddddddddddddddddddddddddddccccbbbbbbbbbbbbbbbbbbbb
bbbbbbbbbbbbbbbbbbbcccdddcddddddddddddddddddddddddddddddddddddddddddddddddddddddddddddcccbbbbbbbbbbbbbbbbb
bbbbbbbbbbbbbbbbcccddddddcdddddddddddddddddddddddddddddddddddddddddddddddddddddddddddddddcccbbbbbbbbbbbbbb
bbbbbbbbbbbbbcccdddddddddcddddddddddddddddddddddddddddddddddddddddddddddddddddddddddddddddddcccbbbbbbbbbbb
bbbbbbbbbbcccddddddddddddcdddddddddddddddddddddddddddddddddddddddddddddddddddddddddddddddddddddcccbbbbbbbb
bbbbbbbbccdddddddddddddddcddddddddddddddddddddddddddddddddddddddddddddddddddddddddddddddddddddddddccbbbbbb
bbbbbbccdddddddddddddddddcddddddddddddddddddddddddddddddddddddddddddddddddddddddddddddddddddddddddddccbbbb
bbbbccccccccccccccccccceccddddddddddddddddddddddddddddddddddddddddddddddddddddddddddddddddddddddddddddccbb
bbccdddddddddddddddddddddfddddddddddddddddddddddddddddddddddddddddddddddddddddddddddddddddddddddddddddddcc
bbccdddddddddddddddddddddfdddddddddddhddddddddddddddddddddddddddddddddddgdddddddddddddddddddddddddddddddcc
bbbbccccccccccccccccccceccddddddddddddddddddddddddddddddddddddddddddddddddddddddddddddddddddddddddddddccbb
bbbbbbccdddddddddddddddddcddddddddddddddddddddddddddddddddddddddddddddddddddddddddddddddddddddddddddccbbbb
bbbbbbbbccdddddddddddddddcddddddddddddddddddddddddddddddddddddddddddddddddddddddddddddddddddddddddccbbbbbb
bbbbbbbbbbcccddddddddddddcdddddddddddddddbdddddddddddddddddddddddddddddddddddddddddddddddddddddcccbbbbbbbb
bbbbbbbbbbbbbcccdddddddddcddddddddddddddddddddddddddddddddddddddddddddddddddddddddddddddddddcccbbbbbbbbbbb
bbbbbbbbbbbbbbbbcccddddddcdddddddddddddddddddddddddddddddddddddddddddddddddddddddddddddddcccbbbbbbbbbbbbbb
bbbbbbbbbbbbbbbbbbbcccdddcddddddddddddddddddddddddddddddddddddddddddddddddddddddddddddcccbbbbbbbbbbbbbbbbb
bbbbbbbbbbbbbbbbbbbbbbccccddddddddddddddddddddddddddddddddddddddddddddddddddddddddccccbbbbbbbbbbbbbbbbbbbb
bbbbbbbbbbbbbbbbbbbbbbbbbbccccccccccccccccccccccccccccccccccccccccccccccccccccccccbbbbbbbbbbbbbbbbbbbbbbbb
bbbbbbbbbbbbbbbbbbbbbbbbbbbbbbbbbbbbbbbbbbbbbbbbbbbbbbbbbbbbbbbbbbbbbbbbbbbbbbbbbbbbbbbbbbbbbbbbbbbbbbbbbb
aaaaaaaaaaaaaaaaaaaaaaaaaaaaaaaaaaaaaaaaaaaaaaaaaaaaaaaaaaaaaaaaaaaaaaaaaaaaaaaaaaaaaaaaaaaaaaaaaaaaaaaaaa
aaaaaaaaaaaaaaaaaaaaaaaaaaaaaaaaaaaaaaaaaaaaaaaaaaaaaaaaaaaaaaaaaaaaaaaaaaaaaaaaaaaaaaaaaaaaaaaaaaaaaaaaaa
aaaaaaaaaaaaaaaaaaaaaaaaaaaaaaaaaaaaaaaaaaaaaaaaaaaaaaaaaaaaaaaaaaaaaaaaaaaaaaaaaaaaaaaaaaaaaaaaaaaaaaaaaa
aaaaaaaaaaaaaaaaaaaaaaaaaaaaaaaaaaaaaaaaaaaaaaaaaaaaaaaaaaaaaaaaaaaaaaaaaaaaaaaaaaaaaaaaaaaaaaaaaaaaaaaaaa
aaaaaaaaaaaaaaaaaaaaaaaaaaaaaaaaaaaaaaaaaaaaaaaaaaaaaaaaaaaaaaaaaaaaaaaaaaaaaaaaaaaaaaaaaaaaaaaaaaaaaaaaaa
aaaaaaaaaaaaaaaaaaaaaaaaaaaaaaaaaaaaaaaaaaaaaaaaaaaaaaaaaaaaaaaaaaaaaaaaaaaaaaaaaaaaaaaaaaaaaaaaaaaaaaaaaa
aaaaaaaaaaaaaaaaaaaaaaaaaaaaaaaaaaaaaaaaaaaaaaaaaaaaaaaaaaaaaaaaaaaaaaaaaaaaaaaaaaaaaaaaaaaaaaaaaaaaaaaaaa
aaaaaaaaaaaaaaaaaaaaaaaaaaaaaaaaaaaaaaaaaaaaaaaaaaaaaaaaaaaaaaaaaaaaaaaaaaaaaaaaaaaaaaaaaaaaaaaaaaaaaaaaaa
"}
