"a" = (/turf/simulated/ocean,/area/space)
"b" = (/turf/simulated/open,/area/beach)
"c" = (/turf/simulated/wall/constructed/r_wall/hull,/area/beach)
"d" = (/turf/simulated/floor/tiled/dark,/area/neptune/engine_room)
"e" = (/turf/simulated/floor/tiled/dark,/area/neptune/boiler_room)
"f" = (/turf/simulated/floor/tiled/dark,/area/neptune/cargo_hold)
"g" = (/obj/structure/ladder/up,/turf/simulated/floor/tiled/dark,/area/neptune/boiler_room)
"h" = (/obj/structure/stairs,/turf/simulated/floor/tiled/dark,/area/neptune/cargo_hold)
"i" = (/obj/effect/landmark/map_data,/turf/simulated/floor/tiled/dark,/area/neptune/boiler_room)

(1,1,1) = {"
aaaaaaaaaaaaaaaaaaaaaaaaaaaaaaaaaaaaaaaaaaaaaaaaaaaaaaaaaaaaaaaaaaaaaaaaaaaaaaaaaaaaaaaaaaaaaaaaaaaaaaaaaa
aaaaaaaaaaaaaaaaaaaaaaaaaaaaaaaaaaaaaaaaaaaaaaaaaaaaaaaaaaaaaaaaaaaaaaaaaaaaaaaaaaaaaaaaaaaaaaaaaaaaaaaaaa
aaaaaaaaaaaaaaaaaaaaaaaaaaaaaaaaaaaaaaaaaaaaaaaaaaaaaaaaaaaaaaaaaaaaaaaaaaaaaaaaaaaaaaaaaaaaaaaaaaaaaaaaaa
aaaaaaaaaaaaaaaaaaaaaaaaaaaaaaaaaaaaaaaaaaaaaaaaaaaaaaaaaaaaaaaaaaaaaaaaaaaaaaaaaaaaaaaaaaaaaaaaaaaaaaaaaa
aaaaaaaaaaaaaaaaaaaaaaaaaaaaaaaaaaaaaaaaaaaaaaaaaaaaaaaaaaaaaaaaaaaaaaaaaaaaaaaaaaaaaaaaaaaaaaaaaaaaaaaaaa
aaaaaaaaaaaaaaaaaaaaaaaaaaaaaaaaaaaaaaaaaaaaaaaaaaaaaaaaaaaaaaaaaaaaaaaaaaaaaaaaaaaaaaaaaaaaaaaaaaaaaaaaaa
aaaaaaaaaaaaaaaaaaaaaaaaaaaaaaaaaaaaaaaaaaaaaaaaaaaaaaaaaaaaaaaaaaaaaaaaaaaaaaaaaaaaaaaaaaaaaaaaaaaaaaaaaa
aaaaaaaaaaaaaaaaaaaaaaaaaaaaaaaaaaaaaaaaaaaaaaaaaaaaaaaaaaaaaaaaaaaaaaaaaaaaaaaaaaaaaaaaaaaaaaaaaaaaaaaaaa
aaaaaaaaaaaaaaaaaaaaaaaaaaaaaaaaaaaaaaaaaaaaaaaaaaaaaaaaaaaaaaaaaaaaaaaaaaaaaaaaaaaaaaaaaaaaaaaaaaaaaaaaaa
aaaaaaaaaaaaaaaaaaaaaaaaaaaaaaaaaaaaaaaaaaaaaaaaaaaaaaaaaaaaaaaaaaaaaaaaaaaaaaaaaaaaaaaaaaaaaaaaaaaaaaaaaa
bbbbbbbbbbbbbbbbbbbbbbbbbbbbbbbbbbbbbbbbbbbbbbbbbbbbbbbbbbbbbbbbbbbbbbbbbbbbbbbbbbbbbbbbbbbbbbbbbbbbbbbbbb
bbbbbbbbbbbbbbbbbbbbbbbbbbccccccccccccccccccccccccccccccccccccccccccccccccccccccccbbbbbbbbbbbbbbbbbbbbbbbb
bbbbbbbbbbbbbbbbbbbbbbccccdddddddddceeeeeeeeeeeeeeeeeecceeeeeeeeeeeeeeeeeecfffffffccccbbbbbbbbbbbbbbbbbbbb
bbbbbbbbbbbbbbbbbbbcccdddddddddddddceeeeeeeeeeeeeeeeeecceeeeeeeeeeeeeeeeeecfffffffffffcccbbbbbbbbbbbbbbbbb
bbbbbbbbbbbbbbbbcccddddddddddddddddceeeeeeeeeeeeeeeeeecceeeeeeeeeeeeeeeeeecffffffffffffffcccbbbbbbbbbbbbbb
bbbbbbbbbbbbbcccdddddddddddddddddddceeeeeeeeeeeeeeeeeecceeeeeeeeeeeeeeeeeecfffffffffffffffffcccbbbbbbbbbbb
bbbbbbbbbbcccddddddddddddddddddddddceeeeeeeeeeeeeeeeeecceeeeeeeeeeeeeeeeeecffffffffffffffffffffcccbbbbbbbb
bbbbbbbbccdddddddddddddddddddddddddceeeeeeeeeeeeeeeeeecceeeeeeeeeeeeeeeeeecfffffffffffffffffffffffccbbbbbb
bbbbbbccdddddddddddddddddddddddddddceeeeeeeeeeeeeeeeeecceeeeeeeeeeeeeeeeeecfffffffffffffffffffffffffccbbbb
bbbbccdddddddddddddddddddddddddddddceeeeeeeeeeeeeeeeeecceeeeeeeeeeeeeeeeeecfffffffffffffffffffffffffffccbb
bbccdddddddddddddddddddddddddddddddceeeeeeeeeeeeeeeeeecceeeeeeeeeeeeeeeeeecfffffffffffffffffffffffffffffcc
bbccdddddddddddddddddddddddddddddddcegeeeeeeeeeeeeeeeecceeeeeeeeeeeeeeeegecffffffhffffffffffffffffffffffcc
bbbbccdddddddddddddddddddddddddddddceeeieeeeeeeeeeeeeecceeeeeeeeeeeeeeeeeecfffffffffffffffffffffffffffccbb
bbbbbbccdddddddddddddddddddddddddddceeeeeeeeeeeeeeeeeecceeeeeeeeeeeeeeeeeecfffffffffffffffffffffffffccbbbb
bbbbbbbbccdddddddddddddddddddddddddceeeeeeeeeeeeeeeeeecceeeeeeeeeeeeeeeeeecfffffffffffffffffffffffccbbbbbb
bbbbbbbbbbcccddddddddddddddddddddddceeeeeeeeeeeeeeeeeecceeeeeeeeeeeeeeeeeecffffffffffffffffffffcccbbbbbbbb
bbbbbbbbbbbbbcccdddddddddddddddddddceeeeeeeeeeeeeeeeeecceeeeeeeeeeeeeeeeeecfffffffffffffffffcccbbbbbbbbbbb
bbbbbbbbbbbbbbbbcccddddddddddddddddceeeeeeeeeeeeeeeeeecceeeeeeeeeeeeeeeeeecffffffffffffffcccbbbbbbbbbbbbbb
bbbbbbbbbbbbbbbbbbbcccdddddddddddddceeeeeeeeeeeeeeeeeecceeeeeeeeeeeeeeeeeecfffffffffffcccbbbbbbbbbbbbbbbbb
bbbbbbbbbbbbbbbbbbbbbbccccdddddddddceeeeeeeeeeeeeeeeeecceeeeeeeeeeeeeeeeeecfffffffccccbbbbbbbbbbbbbbbbbbbb
bbbbbbbbbbbbbbbbbbbbbbbbbbccccccccccccccccccccccccccccccccccccccccccccccccccccccccbbbbbbbbbbbbbbbbbbbbbbbb
bbbbbbbbbbbbbbbbbbbbbbbbbbbbbbbbbbbbbbbbbbbbbbbbbbbbbbbbbbbbbbbbbbbbbbbbbbbbbbbbbbbbbbbbbbbbbbbbbbbbbbbbbb
aaaaaaaaaaaaaaaaaaaaaaaaaaaaaaaaaaaaaaaaaaaaaaaaaaaaaaaaaaaaaaaaaaaaaaaaaaaaaaaaaaaaaaaaaaaaaaaaaaaaaaaaaa
aaaaaaaaaaaaaaaaaaaaaaaaaaaaaaaaaaaaaaaaaaaaaaaaaaaaaaaaaaaaaaaaaaaaaaaaaaaaaaaaaaaaaaaaaaaaaaaaaaaaaaaaaa
aaaaaaaaaaaaaaaaaaaaaaaaaaaaaaaaaaaaaaaaaaaaaaaaaaaaaaaaaaaaaaaaaaaaaaaaaaaaaaaaaaaaaaaaaaaaaaaaaaaaaaaaaa
aaaaaaaaaaaaaaaaaaaaaaaaaaaaaaaaaaaaaaaaaaaaaaaaaaaaaaaaaaaaaaaaaaaaaaaaaaaaaaaaaaaaaaaaaaaaaaaaaaaaaaaaaa
aaaaaaaaaaaaaaaaaaaaaaaaaaaaaaaaaaaaaaaaaaaaaaaaaaaaaaaaaaaaaaaaaaaaaaaaaaaaaaaaaaaaaaaaaaaaaaaaaaaaaaaaaa
aaaaaaaaaaaaaaaaaaaaaaaaaaaaaaaaaaaaaaaaaaaaaaaaaaaaaaaaaaaaaaaaaaaaaaaaaaaaaaaaaaaaaaaaaaaaaaaaaaaaaaaaaa
aaaaaaaaaaaaaaaaaaaaaaaaaaaaaaaaaaaaaaaaaaaaaaaaaaaaaaaaaaaaaaaaaaaaaaaaaaaaaaaaaaaaaaaaaaaaaaaaaaaaaaaaaa
aaaaaaaaaaaaaaaaaaaaaaaaaaaaaaaaaaaaaaaaaaaaaaaaaaaaaaaaaaaaaaaaaaaaaaaaaaaaaaaaaaaaaaaaaaaaaaaaaaaaaaaaaa
"}
